WE  textures/5.xpm
SO textures/7.xpm
NO  textures/6.xpm
EA textures/8.xpm

F 5       0,2  0  0,  2    0
C 0,0,0

1111111
1000001
10N111
11111