WE  textures/1.xpm
NO  textures/2.xpm
SO textures/3.xpm
EA textures/4.xpm

F 30,30,35
C 15,15,15

111111111111111111111
100000000000000000001
1000000000000000N0011
111111111111111111111