NO ./textures/1.xpm
SO ./textures/2.xpm
WE ./textures/3.xpm
EA ./textures/4.xpm
F 220,100,0
C 225,30,0

111111
10N101
101111
111 11
111 111