WE  textures/1.xpm
NO  textures/2.xpm
SO textures/3.xpm
EA textures/4.xpm

F 30,30,35
C 15,15,15

        1111111111111111111111111
        1000110000100000000000001
        1000110000000000111111001
        1000110000000000110001001
       1000000000100000000001001
111111111111111111111111111111111
1000110000100000000000001
10001100000000N0111111001
1000110000100000110001001                111111111
1111111111 100000000001001               111100001
1111111111 111111111111111               111111111
1111111111 100000000001001
1111111111 111111111111111   
1111111111111111111111111           
100011000010000000000000111111111111 
1000110000000000111111001
1000110000000000110001001
1000000000100000000001001
1111111111111111111111111