WE  textures/5.xpm
NO  textures/6.xpm
SO textures/7.xpm
EA textures/8.xpm

F 244,164,96
C 135,206,235

111111111111111111111
1000000000000000000011111111111111111
1000000000000000N00111           1001
111111111111111111111            1111
