NO textures/north.xpm
SO textures/south.xpm
WE textures/west.xpm
EA textures/east.xpm

F 244,164,96
C 135,206,235

111111111111111111111111111111111
100000000011000000000000100010011
10110000001100011100000000100001
1001001010001000000100000111111011
1001000000100000000000001   10011
1001000100111111111000001   10001
1000110000010000001000001    111
111111000011000W00100000111
100000000000000000100000001
11111111111111111111111111