NO textures/north.xpm
SO textures/south.xpm
WE textures/west.xpm
EA textures/east.xpm

F 244,164,96
C 135,206,235

11111111111111111
10000000000000001
10001110001110001
10001110001110001
10000000000000001
11111111100011111
11111111100011111
10000000000000001
10111111111111111
10000000011111111
10000000011111111
10111111111111111
1000000W111111111
11111111111111111