NO textures/north.xpm
SO textures/south.xpm
WE textures/west.xpm
EA textures/east.xpm

F 244,164,96
C 135,206,235

111111111111111
100000100000001
101110101111101
100010101000101
111010101010101
100010001010001
101111111011111
1000000000000W1
111111111111111