NO textures/north.xpm
SO textures/south.xpm
WE textures/west.xpm
EA textures/east.xpm

F 244,164,96
C 135,206,235

111111
100001
10W001
100001
111111