
WE  textures/5.xpm
NO  textures/6.xpm
SO textures/7.xpm
EA textures/8.xpm

F 244,164,96
C 135,206,235

1111111111111111111111111111111111111111111111111
10S0110000100000000000001000000000000000000000001                          
1000110000000000111111001000000000000000000000001
1000110000000000110001001000000000000000000000001
1000000000100010000001001000000000000000000000001
1110000000000000000000000000000000000000000000001
1000000000000000000000000000000000000000000000001
1111111111111111111111111111111111111111111111111  
