NO textures/north.xpm
SO textures/south.xpm
WE textures/west.xpm
EA textures/east.xpm

F 244,164,96
C 135,206,235

11111111
1000000001
100E000 
111111111