NO textures/north.xpm
SO textures/south.xpm
WE textures/west.xpm
EA textures/east.xpm

F 244,164,96
C 535,300,235

11111111
10N0001111
100010010111
1111111111