NO textures/north.xpm
SO textures/south.xpm
WE textures/west.xpm
EA textures/east.xpm

F 244,164,96
C 135,206,235

11111111
100N0001
10000S01
11111111